==............
==............
==............
==............
==............
==............
==............
==............
==............
==............
==............
==............
==............
==............
==............
==............
==...?........
==............
==............
==............
==...b........
==...!........
==g..b...?....
==...?........
==...b........
==............
==............
==............
==pp..........
==pp..........
==............
==............
==............
==............
==............
==............
==............
==............
==ppp.........
==ppp.........
==g...........
==............
==............
==............
==............
==............
==pppp........
==pppp........
==............
==............
==............
==............
==g...........
==g...........
==............
==............
==............
==pppp........
==pppp........
==............
==............
==............
==............
==............
==............
==............
==............
==............
==............
..............
..............
==............
==............
==............
==............
==............
==............
==...b........
==...!........
==...b........
==.......bg...
==.......b....
==.......bg...
==.......b....
==.......b....
==.......b....
.........b....
.........b....
..............
==............
==............
==.......b....
==.......b....
==.......b....
==...b...?....
==............
==............
==............
==g...........
==g...........
==...b........
==...b........
==............
==............
==............
==............
==...?........
==k...........
==............
==...?...!....
==............
==............
==...?........
==............
==............
==g...........
==g...........
==............
==...b........
==............
==............
==.......b....
==.......b....
==.......b....
==............
==g...........
==g...........
==............
==.......b....
==g..b...?....
==g..b...?....
==.......b....
==............
==............
==-...........
==--..........
==---.........
==----........
==............
==............
==----........
==---.........
==--..........
==-...........
==............
==............
==............
==............
==-...........
==--..........
==---.........
==----........
==----........
..............
..............
==----........
==---.........
==--..........
==-...........
==............
==............
==............
==............
==pp..........
==pp..........
==............
==............
==............
==...b........
==...b........
==...?........
==...b........
==............
==............
==............
==g...........
==g...........
==............
==............
==pp..........
==pp..........
==-...........
==--..........
==---.........
==----........
==-----.......
==------......
==-------.....
==--------....
==---------...
==............
==............
==............
==............
==............
==............
==............
==............
==F...........
==............
==............
==............
==A...........
