103
==A...........
==............
==............
==............
==............
==............
==............
==............
==............
==............
==............
==............
==............
==............
==............
==............
==............
==k...........
==............
==............
==............
==............
==............
==............
==g...........
==g...........
==g...........
==............
==............
==............
==............
==............
==............
==k...........
==k...........
==k...........
==............
==............
==............
==............
==............
==............
==............
==............
==k...........
==k...........
==............
==............
==............
==-...........
==............
==............
==............
==............
==............
==...0........
==...0........
==...0........
==............
==............
==---...!.....
==............
==............
==............
==............
==............
==k...........
==............
==............
==............
==............
==g...........
==g...........
==g...........
==............
==--..........
==............
==...b...b....
==k...........
==--..........
..............
..............
==............
==............
==............
==............
==............
==............
==............
==............
==............
==............
==k...........
==............
==............
==............
==............
==............
==............
==............
==............
==............
==............
==............
==............
==............
==............
==............
==............
==............
==............
==k...........
==............
==............
==............
==............
==............
==............
==............
==g...........
==g...........
==g...........
==............
..............
..............
==............
==--....b.....
==............
..............
..............
==............
==............
==............
==............
==k...........
==............
==............
==............
==............
==............
==k...........
==k...........
==k...........
==............
==............
==............
==............
==............
==............
==............
==............
==k...........
==k...........
==............
==............
==............
==............
==............
==............
==............
==............
==............
==k...........
==k...........
==k...........
==............
==............
==............
==......0.....
==ppp...0.....
==ppp...0.....
==......0.....
==............
==............
==............
==k...........
==............
==............
==............
==g...........
==g...........
==g...........
==............
==............
==............
==............
==............
==............
==g...........
==g...........
==g...........
==............
==-...........
==--..........
==---.........
==----........
==-----.......
==------......
==-------.....
==--------....
==---------...
==............
==............
==............
==............
==............
==............
==............
==............
==F...........
==............
==............
==............
==A...........
