102
==A...........
==............
==............
==............
==............
==............
==............
==............
==............
==............
==...b........
==...b........
==...b........
==............
==............
==............
==............
==............
==............
==pppp........
==pppp........
==............
==............
==.......b....
==.......b....
==.......b....
==k...........
==............
==pppp........
==pppp........
==............
==............
==....-pp.....
==....-pp.....
==............
==pp..........
==pp..........
==pp..........
==pp..........
==............
==............
==............
==............
==k...........
==............
==............
==pppp........
==pppp........
==............
==............
==............
==...b........
==...b........
==............
==............
==............
==ppppp.......
==ppppp.......
==............
==............
==............
==............
==...-pp......
==...-pp......
==............
==............
==............
==pp.....bg...
==pp.....bg...
==.......b....
==.......b....
==.......b....
==............
==............
==pp..........
==pp..........
==............
==.......b....
==.......b....
==.......b....
==ppp....b....
==ppp....b....
==............
==............
==pp..........
==pp..........
==............
==pppppp......
==pppppp......
==............
==............
==............
==............
==............
==ppp.........
==ppp.........
==............
==............
==............
==............
==............
==............
==pppp........
==pppp........
==............
==pp..........
==pp..........
==............
==............
==............
==...b........
==...-ppp.....
==...-ppp.....
==...b........
==............
==pp.....b....
==pp..........
==............
==............
==.......b....
==.......b....
==.......b....
==.......b....
.........b....
.........b....
.........b....
.........b....
.........b....
..............
==............
==............
==pp..........
==pp..........
==............
==............
==pp..........
==pp..........
==............
==....b.......
==....b.......
==.......b....
.........b....
==............
..............
==...b........
==...b...b....
==...b...b....
==............
==............
==-...........
==--..........
==---.........
..............
==ppp.........
==ppp.........
==............
==----........
==--..........
==............
==............
==...b...b....
==...b...b....
==...b...b....
==............
==............
==............
==............
==...-ppp.....
==...-ppp.....
==............
==g...........
==g...........
==............
==............
==pppp........
==pppp........
==............
==............
==............
==pp..........
==pp..........
==ppp.........
==ppp.........
==pppp........
==pppp........
==............
==............
==............
==............
==ppp.........
==ppp.........
==............
==............
==............
==............
==............
==............
==............
==............
==-...........
==--..........
==pppp........
==pppp........
==-----.......
==------......
==-------.....
==--------k...
==--------....
==............
==............
==............
==............
==............
==............
==............
==............
==F...........
==............
==............
==............
==A...........
